whdw.conf	Vauclair, Sion, White Dwarfs, Kluwer
aagq.conf	ASTROPHYS. ACTIVE GALAX.&QSOS: STA.CRUZ 1985
acfp.conf	ASTRONOMY COSMOLOGY & FUND.PHYSICS: 3RD ESO-CERN
acm..conf	ASTEROIDS COMETS METEORS: UPPSALA:1983JUN20-22
acm..proc	Asteroid, Comet, Meteors 1991
acm..proc	Asteroid, Comet, Meteors 1993
acsw.conf	ASTROPHYSICAL COSMOLOGY: STUDY WEEK: SEP-OCT 1982
adlg.conf	L'ACTIVITE DANS LES GALAXIES - PARIS - 1987JUNE
adra.conf	AUTOMATED DATA RETRIEVAL IN ASTRONOMY=IAU COLL#64
adsx.conf	ACCRETION-DRIVEN STELLAR X-RAY SOURCES
adsx.conf	Accretion Driven Stellar X-Ray Sources, eds. W. H. G. Lewin, E. P. J. van den Heuvel, Cambridge University Press
adu..conf	200TH.ANNIV.DISC.URANUS:BATH/1982APR:IAU COLL.#60
aeas.conf	ACCURACY / ELEMENT ABUND. / STELLAR ATMOSPHERES
agn..conf	ACTIVE GALACTIC NUCLEI / GEORGIA STATE UNIV 1987
aia..conf	ATOMS IN ASTROPHYSICS
aiaa.meet	Proc. AIAA
ais..conf	ASTRONOMICAL INFRARED SPECTROSCOPY: FUT.OBS.DIR.
amd..conf	APPL.MOD.DYN./CELEST.MECH.&ASTRODYN.:NATO 1981AUG
amml.conf	ANGULAR MOMENTUM AND MASS LOSS FOR HOT STARS
anr..conf	APPROACHES TO NUMERICAL RELATIVITY - SOUTHAMPTON
ans..conf	ACCRETING NEUTRON STARS MAX-PLANCK-INSTITUT
aoa..conf	ACTIVITY & OUTER ATMOS. / SUN&STARS: SAAS-FEE 11
apgc.conf	ASTROPH. PARAM. GLOB. CLUST: I.A.U.COLL.68: 1981
araa.conf	ARCHAEOASTRONOMY IN THE AMERICAS: SANTA FE 1981
ards.conf	ACTIVITY IN RED DWARF STARS: IAU COLL.71:CATANIA
arnw.conf	ARCHAEOASTRONOMY IN THE NEW WORLD: OXFORD: 81SEP
asas.conf	ASTRONOMY AND ASTROPHYSICS FOR THE 1980'S -
asdb.conf	ASTRODATA DATABASE
asje.work	ASTROPHYSICAL JETS, WORKSHOP: OCT82:TORINO,ITALY
asph.conf	ASTRONOMICAL PHOTOGRAPHY 1981: CNRS 1981MAY
asph.conf	ASTRONOMICAL PHOTOGRAPHY 1984: EDINBURGH 84APR
aspr.conf	ASIAN-SOUTH PACIFIC REGIONAL MTG. ASTRONOMY, 1ST
atot.conf	ADVANCED TECHNOLOGY OPTICAL TELESCOPES III
auob.conf	AURORAL OBSERVATIONS. TROMSO, NORWAY 1976
auph.conf	PROCEEDINGS OF THE CONFERENCE ON AURORAL PHYSICS
auro.rept	THE AURORAL OBSERVATORY. TROMSO, NORWAY 1982
aust.conf	ESA/ESO - ASTRONOMICAL USES SPACE TELESCOPE 1979
aust.conf	ESA/ESO: ASTRON. USES SPACE TELESCOPE - FEB1979
awia.conf	In Astrophysics with Infrared Arrays , ed. R Elston
bbec.conf	THE BIG BANG AND ELEMENT CREATION: LONDON: 82MAR
biof.conf	BIRTH & INFANCY OF STARS: NATO: LES HOUCHES 61
bllo.conf	Wolfe A. M., ed., Pittsburgh Conference on BL Lac Objects
bmst.conf	BINARY&MULT.STARS TRACERS STELL.EVOL: IAU COLL69,
botu.conf	BIRTH OF THE UNIVERSE - 17TH MORIOND: LES ARCS
botu.conf	BIRTH OF THE UNIVERSE: 17TH MORIOND ASTROPHYS: 82
caa..conf	COSMOLOGY AND ASTROPHYSICS: CORNELL: 1982OCT9-11
cap..conf	COSMOLOGY AND PARTICLES - 16TH MORIOND: LES ARCS
ccg..conf	Groups and Clusters of Galaxies, eds. F. Mardirossian et al.
cemo.conf	CEPHEID MODELING: GODDARD: NASA SP 383 - 1975JUL
cgd..conf	COSMICAL GAS DYNAMICS / MANCHESTER CONFERENCE
cgxs.conf	COMPACT GALACTIC X-RAY SOURCES: WASH.,D.C.: 1979
chcn.conf	COMPARATIVE HI CONTENT/NORMAL GALAXIES:GREENBANK
chdg.conf	COMET HALLEY DUST & GAS ENVIR.: NASA/ESA: 81AUG
chmh.work	COMET HALLEY MICROMETEOROID HAZARD WORKSHOP 1979
cia..conf	CHAOS IN ASTROPHYSICS: NATO: FLORIDA 1985:
cia..conf	COMPENDIUM IN ASTRONOMY
cira.conf	CLASSICS IN RADIO ASTRONOMY
citu.conf	CLUSTERING IN THE UNIVERSE
clga.meet	CLUSTERS OF GALAXIES MEETING: BALTIMORE,MD.
clst.conf	CLASSIFICATION STELLAIRE - GOUTELAS 3RD APR1980 1980
coco.conf	COSMOLOGICAL CONSTANTS
cocr.conf	COMPOSITION & ORIGIN OF COSMIC RAYS: 82
cocr.conf	COMPOSITION & ORIGIN OF COSMIC RAYS:82
come.coll	Comets, ed. L. L. Wilkening (Tucson: University of Arizona Press)
comi.work	WORKSHOP COMETARY MISSIONS - BAMBERG
comp.symp	in 4th Compton Symposium
cosa.conf	CALIBRATION OF STELLAR AGES / WESLEYAN UNIV.
cpg..conf	COLORS AND POPULATIONS OF GALAXIES - PARIS 1981
crca.conf	COSMIC RADIAT./CONTEMP.ASTROPHYSICS: NATO 1986
cscg.conf	CLUSTERS AND SUPERCLUSTERS OF GALAXIES: NATO/ASI
csim.conf	CHEMISTRY/SPECTROSCOPY / INTERSTELLAR MOLECULES
csss.conf	COMETS / SPACE SCIENCE SERIES
csss.conf	COOL STARS STELL.SYST. & SUN - CAMBRIDGE JAN1980
csss.conf	COOL STARS STELL.SYST.&SUN: 2D CAMBRIDGE OCT1981:1,
csss....1	In Cool Stars, Stellar Systems, and the Sun, ed. AK Dupree
csss....6	Cool Stars, Stellar Systems and the Sun, ed. G. Wallerstein
ctdm.conf	CURR.TECH.DOUBLE&MULT.STAR RESEARCH: IAU: COLL62
cto..conf	CEPHEIDS: THEORY&OBS.:IAU COLL.82: TORONTO 84JUN
cvro.conf	CATACLYS.VARIAB.&REL.OBJECTS: IAU.COLL72 - HAIFA
daan.work	DATA ANALYSIS WORKSHOP - 2ND ESO.ST-ECF GARCHING
daan.work	DATA ANALYSIS WORKSHOP - 3RD ESO/ST-ECF GARCHING
daan.work	DATA ANALYSIS WORKSHOP - 4TH ESO/ST-ECF GARCHING
daan.work	ESO/ST-ECF DATA ANALYSIS WORKSHOP:1ST: GARCHING
daia.conf	DATA ANALYSIS IN ASTRONOMY - IV
dir..conf	DIGITAL IMAGE RESTORATION
dli..conf	DIFFRACTION-LIMIT.IMAGING/ VERY LARGE TELESCOPES
dmig.conf	DIFFUSE MATTER / GALAXIES: NATO: CARGESE,ITALY:82
dmig.conf	DIFFUSE MATTER IN GALAXIES: CARGESE:SEP82
dmiu.conf	DARK MATTER IN THE UNIVERSE
dmsu.conf	DARK MATTER AND THE STRUCTURE OF THE UNIVERSE
dodg.conf	DYNAMICS OF DISC GALAXIES: VARBERG CASTLE SWEDEN
dssp.conf	DYNAMICS & STRUCTURE/SOLAR PROMINENCES: MALLORCA
dwga.work	ESO/ESA WORKSHOP / DWARF GALAXIES - GENEVA -1980
eamb.conf	EJECTION AND ACCRETION OF MATTER IN BINARY SYST.
eas..conf	ENGINEERING AND SCIENCE
eas..conf	ENGINEERING AND SCIENCE / CALTECH
ebas.conf	EXCIT.&BROADENING ATOM.SPECT.ASTROPHYS. INTEREST
eds..conf	ELASTIC AND DIFFRACTIVE SCATTERING: 2ND BLOIS
egm..work	EXTRAGALACTIC MOLECULES: WORKSHOP GREENBANK 1982
egsp.conf	The Evolution of Galaxies and Stellar Populations, ed. Tinsley, Larson
egte.conf	The Environment and Evolution of Galaxies, edited by I. M. Shull and H. A. Thronson
ehac....1	20th ESLAB Symp., ESA SP-250, Vol. 1
ehac....2	20th ESLAB Symp., ESA SP-250, Vol. 2
eitu.conf	EVOLUTION IN THE UNIVERSE: ESO: GARCHING 1981MAY
eiu..conf	ELEMENTS / ISOTOPES / UNIVERSE - LIEGE - JUN1979
emls.conf	EFFECTS MASS LOSS STELL.EVOLUTION IAU COLL59 1981
ena..conf	ESSAYS IN NUCLEAR ASTROPHYSICS: WILLIAM FOWLER
eora.work	WORKSHOP S.P.S. - EFF. OPT. RADIO ASTR. MAY1980
eora.work	WORKSHOP SPS - EFFECTS OPT.&RADIO ASTR. MAY1980
epos.conf	ENERGETIC PHENOMENA ON THE SUN - 1986-1984 GSFC
epos.conf	ENERGETIC PHENOMENA ON THE SUN: 1986-1984 GSFC
esf..coll	Eruptive Solar Flares , ed Z Svestka, BV Jackson, ME Machado, Lect. Notes Phys. 399
eso..rept	SCIENTIFIC REPORT. EUROPEAN SOUTHERN OBS.
eso..work	ESO WORSKHOP ON THE SUPERNOVA 1987A: GARCHING
esoi.work	ESO INFRARED WORKSHOP: 2D: GARCHING 1982APR20-23
fcra.rept	REPORT. FIVE COLLEGE RADIO ASTRON. OBS.
fcro.rept	REPORTS. FIVE COLLEGE RADIO ASTRONOMY OBS.
fgts.symp	Airborne Astronomy Symposium on the Galactic Ecosystem: From Gas to Stars to Dust
fic..conf	FUND. INTERACTIONS & COSMOLOGY: 1985 CARGESE
fmpn.coll	From Miras to Planetary Nebulae, eds. M.O. Mennessier, A. Omont
fogh.conf	 In Formation of the Galactic Halo, Inside and Out , ed. H Morrison, A Sarajedini
fps..conf	FORMATION OF PLANETARY SYSTEMS: CNES: GRASSE: 80
fseg.conf	FORMATION,STRUCTURE&EVOLUTION/GALAXIES:CECAM:1981
fseg.conf	FORMATION/STRUCT/EVOLUTION/GALAXIES: CECAM,PARIS
fsro.conf	FLARE STARS AND RELATED OBJECTS: SYMP. BYURAKAN
fstg.conf	From Stars to Galaxies , ed. C. Leitherer, U. Fritze
fstp.conf	From Stardust to Planetesimals
gal..proc	The Galaxy, edited by G. Gilmore and B. Carswell
gamo.conf	GALACTIC MODELS / 4TH FLORIDA / GAINESVILLE 89MAR
gcsg.symp	HARLOW-SHAPLEY SYMP.GLOB CLUST.SYST.IN GALAXIES
gein.work	PROC. WORKSHOP ON GEOPHYSICAL INFORMATICS MOSCOW
geis.conf	GALACTIC & EXTRAGALACTIC INFRARED SPECTR.
gfpg.conf	GRAVIT. FORCE PERPENDICULAR TO THE GALACTIC PLANE
ghog.conf	GASEOUS HALOS OF GALAXIES / NRAO / GREEN BANK 85
gmca.conf	GRAVIT. MAGNETO-CONVECTION & ACCRETION:TEGERNSEE
gmcg.conf	GIANT MOLEC. CLOUDS IN GALAXY - 3 GREGYNOG 1980
goco.conf	GAMOW COSMOLOGY: ENRICO FERMI COURSE 86
grep.conf	GEN.REL.EFFECTS PHYS&ASTROPHYS:EXPER.&THEORY 3RD
grg..conf	9TH INT.CONF.GEN.REL.&GRAVITATION: JENA: 1983JUL
grg..conf	GENERAL RELATIVITY AND GRAVIT.
grg..conf	GENERAL RELATIVITY AND GRAVITATION - BERNE,SWITZ
grg2.conf	GENERAL RELATIVITY AND GRAVIT. II. - BERNE,SWITZ
grt..work	LA JOLLA WORKSHOP ON GAMMA RAY TRANSIENTS - 1982
grtr.conf	GAMMA-RAY TRANSIENTS & REL. ASTROPHYS. PHENOMENA
gxrs.conf	GALACTIC X-RAY SOURCES: NATO - SOUNION,GREECE
haob.rept	ANNUAL REPORT TO DIRECTOR HALE OBSERVATORIES
hea..conf	HIGH ENERGY ASTROPHYSICS / DIJON, FRANCE 1975
hea..conf	HIGH-ENERGY ASTROPH: COSPAR23: BUDAPEST, JUN1981
heta.conf	HIGH ENERGY TRANSIENTS IN ASTROPHYS.: SANTA CRUZ
hgc..conf	HIGHLIGHTS IN GRAVITATION & COSMOLOGY: GOA,INDIA
hhot.symp	HERBIG-HARO OBJECTS, T-TAURI STARS, SYMP: MEXICO
hia..rept	HERZBERG INST. ASTROPH. NAT.RES.COUNCIL NRC
hnis.conf	THERMAL / NONTHERMAL INTERACTIONS IN SOLAR FLARES
hper.conf	HIGH-PREC.EARTH ROTAT.&EARTH-MOON DYN:IAU COLL.63
hrii.conf	HIGH RESOLUTION IMAGING BY INTERFEROMETRY
hrxs.conf	HIGH RESOLUTION X-RAY SPECTROSC./ COSMIC PLASMAS
iaia.conf	IMAGE ANALYSIS IN ASTRONOMY: FIRENZE
iapp.rept	INT. AMATEUR-PROF. PHOTOELECT. PHOTOM. COMMUN.
IAUS....4	Symp. IAU4
IAUS...34	Deinzer, W., Proc. I.A.U. Symp. No.34 "Planetary Nebulae" (D. B. Osterbrock and C. B. O'Dell, ed.) 1968, p. 428, D.Beidel Pubi. Co., Dordrecht.
IAUS...88	Close Binary Stars: Observations and Interpretation, ed. M. J. Plavec, D. M. Popper, and R. K. Ulrich
IAUS..120	Astrochemistry, ed. M. S. Vardya & S. P. Tarafdar 
IAUS..131	Planetary Nebulae
IAUS..139	The Galactic and Extra-galactic Background Radiation, ed. S Bowyer, C Leinert
IAUS..155	In Planetary Nebulae , ed. R. Weinberger, A. Acker
IAUS..155	In Planetary Nebulae: Proceedings of the 155th Symposium
IAUS..155	Nebulae: Proceedings of the 155th Symposium
icii.conf	INTERREL/CIRCUMSTEL/INTERSTEL&INTERPLANET/DUST
icrc.conf	1986 INT.COSMIC-RAY CONF.: LA JOLLA: 1985AUG
ihs..conf	THE INTERNATIONAL HELIOSPHERIC STUDY: COSPAR27
iia..conf	INTERFEROMETRIC IMAGING IN ASTRONOMY / ORACLE,AZ
iie..conf	INTERFER. IDENT.& EXCISION: NRAO: GREENBANK 1982
inco.work	INTERSTELLAR COMETS: WORKSHOP: EDINBURGH 82APR
inpr.conf	SUMMER SCHOOL ON INTERSTELLAR PROCESSES
iop..conf	IDENT.OPTIM.&PROTECTION / OPTIC. TELESCOPE SITES
isas.rept	INST. OF SPACE AND ASTRONAUTICAL SCIENCE. REPORT # 597, 1981
isas.rept	INST. SPACE & ASTRONAUT. SCIENCE. REPORT 597:
isas.rept	REPORT. INST.SPACE AND ASTRONAUTICAL SCIENCE
isc..conf	INFRARED SYSTEMS AND COMPONENTS III 1989JAN
ismg.conf	THE INTERSTELLAR MEDIUM IN GALAXIES / 2D WYOMING
iss..conf	INSTRUMENTATION FOR SUBMILLIMETER SPECTROSCOPY
iss..work	Ices in the Solar System, Klinger, J., Benest, D., Dollfus, A., Smoluchowski, R.
ita..rept	INST. THEORET. ASTROPHYS. BLINDERN-OSLO REPORT
itab.rept	REPORT. INST. THEOR. ASTROPH. BLINDERN
itab.rept	REPORT. INST. THEOR. ASTROPH. BLINDERN/OSLO
iue..conf	2D EUROPEAN IUE CONF.: TUBINGEN: ESA/SP-157 1980
iue..conf	3RD EUR. IUE CONF.: MADRID: 1982MAY10: ESA-SP-176
iue..work	IUE DATA REDUCTION WORKSHOP - VIENNA 1980NOV18-20
jila.rept	JOINT INST. LAB. ASTROPHYSICS. REPORT
jila.rept	REPORT. JOINT INST. LAB. ASTROPHYSICS
kdsm.conf	KINEMAT/DYNAM/STRUCT/MILKY WAY VANCOUVER 1983MAY
kpno.rept	KITT PEAK NAT. OBS. TECH. DEV. PROGRAM REPT.
kpno.rept	PROGRAM REPORT. KITT PEAK NATIONAL OBSERVATORY
kpno.rept	TECH.DEV. PROGRAM REPORT. KITT PEAK NATL. OBS.
lbg6.conf	LANDOLT-BORNSTEIN: GROUP 6: ASTRONOMY
lest.rept	LEST FOUNDATION TECHNICAL REPORT
lest.rept	LEST FOUNDATION. TECHNICAL REPORT
lfve.conf	LOW FREQ.VARIABILITY EXTRAGALACTIC RADIO SOURCES
lisa.conf	LIBRARY & INFO. SERVICES ASTRONOMY: IAU COLL.110
lmsf.conf	LOW MASS STAR FORM. & PRE-MAIN SEQUENCE OBJECTS
lodm.conf	LIGHT ON DARK MATTER: 1ST IRAS CONF. 1986
lois.conf	LAB.& OBS. INFRARED SPECTRA OF INTERSTELLAR DUST
lund.rept	REPORTS. OBSERVATORY OF LUND
mads.conf	ESO - METH. ABUNDANCE DET. FOR STARS - GENEVA
mads.conf	ESO: METH. ABUNDANCE DET. STARS - GENEVA MAR1980
mcmw.conf	MOLECULAR CLOUDS / MILKY-WAY & EXTERNAL GALAXIES
mdg..conf	MORPHOLOGY AND DYNAMICS OF GALAXIES: SAAS-FEE 12
mfeo.conf	MAGNETIC FIELDS & EXTRAGALACTIC OBJECTS: CARGESE
mgm..conf	MARCEL GROSSMANN MEETING: GENERAL RELATIVITY: 2D
mhda.conf	MAGNETOHYDRODYNAMIC ASPECTS / CORONA: PARIS 1980
mia..conf	MONOGRAPHS IN ASTRONOMY. UNIVERSITY OF TEXAS
miis.conf	MOLECULES IN INTERSTELLAR SPACE: PROC. 1981MAY
mmmo.conf	MASERS/MOLEC.&MASS OUTFLOWS/STAR FORM. REGIONS
mms..conf	THE MOST MASSIVE STARS: ESO: GARCHING: 1981NOV
mnia.conf	'86 MASSIVE NEUTRINOS IN ASTROPHYSICS: MORIOND:6
moas.conf	MOLECULAR ASTROPHYSICS: NATO: GERMANY: 1985
motc.conf	MODERN OBS. TECHNIQUES FOR COMETS JPL/81-68
mpie.rept	MAX-PLANCK-INST./EXTRATERRESTRISCHE PHYS. REPORT
mvs..conf	MAGNETIC & VAR. STARS, 5TH - SZOMBATHELY,HUNGARY
nadg.conf	NOYAUX ACTIFS DES GALAXIES GOUTELAS 1981
naic.rept	NATIONAL ASTRONOMY AND IONOSPHERE CENTER. CORNELL UNIVERSITY
nam..conf	NORDIC ASTR.MTG.:OSLO / NORDIC OPTICAL TELESCOPE
nam..conf	NORDIC ASTRONOMY MEETING IN OSLO: 1983AUG15-16
nasa..tms	NASA Tech. Memo.
nasa.rept	NASA TECHNICAL MEMORANDUM
ncgo.conf	NEED/COORD.GROUNDBASED/OBS.HALLEY'S COMET: 82APR
niia.conf	NEW INSIGHTS IN ASTROPHYSICS: 8 YEARS OF IUE
nim..book	Nebulae and Interstellar Matter, ed. Middlehurst, B. M. and Aller, L. H.
nmsa.conf	NONLINEAR METHODS OF SPECTRAL ANALYSIS
nnsp.conf	NONRADIAL AND NONLINEAR STELLAR PULSATION - 1980
nntt.rept	NATL. NEW TECH. TELESCOPE. TECH.DEV.PROG.RPT.
nntt.rept	NNTT/KPNO NAT.NEW TECH.TELESCOPE. TECH.DEV.PROG.RE
npa..conf	NEUTRINO PHYSICS AND ASTROPHYSICS: ERICE#10 1982
nrao.rept	NRAO ELECTRONICS DIVISION INTERNAL REPORT
nro..rept	NOBEYAMA RADIO OBSERVATORY. TECHNICAL REPORT
nro..rept	REPORT. NOBEYAMA RADIO OBSERVATORY
nsgr.conf	NON-SOLAR GAMMA RAYS - COSPAR22 - BANGALORE 1980
nss..conf	THE NATURE OF SYMBIOTIC STARS: IAU COLL#70 1981
nssl.conf	NEARBY STARS & STELL.LUM.FUNCT.:IAU COLL76 83JUN
nuas.conf	NUCLEAR ASTROPHYSICS: 2D PROC.: TEGERNSEE 83JUN
oaeg.conf	ORIGIN & EVOLUTION GALAXIES: NATO: ERICE 1983MAY
obso.conf	OBSERVATIONS SOLAIRES. CENTRE L'ASTRON.&SCI.SPATIALES, 1984
oca..conf	OUR CHANGING ATMOSPHERE / 28TH LIEGE COLLOQUIUM
oeeg.conf	THE ORIGIN AND EARLY EVOLUTION OF THE GALAXIES
oehu.conf	ORIGIN AND EARLY HISTORY OF UNIVERSE: LIEGE 26
oia..conf	OPTICS IN ASTRONOMY: 32ND HERSTMONCEUX CONF.1993
ojig.conf	OPTICAL JETS IN GALAXIES / 2D ESO/ESA - FEB,1981
omeg.conf	Origin of Matter and Evolution of Galaxies
opsi.conf	OSCILLATIONS/PROBE/SUN'S INTERIOR:CATANIA 83JUN
oras.rept	OPT./RAD. ASTROMET. SOURCES / INERTIAL REF.FRAME
orne.symp	SYMP. ON THE ORION NEBULA TO HONOR HENRY DRAPER
oso..rept	ONSALA SPACE OBSERVATORY. RESEARCH REPORT
paps.conf	PARTICLE ACCEL.PROC.SHOCKWAVES/NUCLEOSYNTHESIS...
paha.proc	Leger A., d'Hendecourt L., Boccara N. (eds.) Polycyclic Aromatic Hydrocarbons and Astrophysics
pbes.coll	Physics of Be Stars, ed. A. Slettebak & T. Snow (Cambridge: Cambridge Univ. Press)
pbs..work	WORKSHOP: PULSATING B-STARS: NICE,FRANCE JUL1981
pccv.conf	PULSATIONS IN CLASSICAL & CATACLYS. VAR. STARS
pffl.conf	PHYS. FORM. FEII LINES OUTSIDE LTE: IAU COLL.94
pism.conf	PHASES INTERSTELL. MEDIUM - NRAO, GREENBANK 1981
pkdg.conf	PHOTOMETRY KINEMATICS AND DYN. OF GALAXIES 1980
plri.conf	PLANETARY RINGS / SPACE SCIENCE SERIES
podm.conf	PHYSICS OF DENSE MATTER - COLLOQUE:CNRS, SEP1980
poeu.conf	PHYSICS OF THE EXPANDING UNIVERSE - CRACOW 1979
pomp.conf	PHOT.OBS. MINOR PLANETS ORBIT.ELEM. ASTEROIDS
pos..conf	PHYSICS OF SUNSPOTS - SAC.PEAK-OBS,SUNSPOT 1981
ppfs.conf	PHYS.PROC. IN FRAGMENTATION AND STAR FORMATION
ppm..conf	PLASMA PENETRAT./MAGNETOSPHERES: GREECE: 1986
pprg.work	PHYSICAL PROCESSES IN RED GIANTS - ERICE SEP1981
prhe.work	ESO WORKSHOP/ PRIMORDIAL HELIUM: GARCHING: 83FEB
pric.conf	PROG. IN COSMOLOGY: CHRISTCHURCH, OXFORD 1982SEP
prpl.conf	Protostars and Planets
prpl.conf	Protostars and Planets III
prpl.conf	Protostars and Planets III, ed. E. H. Levy, J. I. Lunine, & M. S. Matthews (Tucson: Univ. of Arizona Press)
psbs.conf	PHOTOMETRIC & SPECTROSCOPIC BINARY SYST. NATO1981
pyco.conf	PHYSICAL COSMOLOGY: LES HOUCHES#32 - 1979JUL2-27
qgl..conf	QUASARS & GRAVITATIONAL LENSES: 24TH LIEGE 83JUN
raoa.conf	RECENT ADV. IN OBSERVATIONAL ASTRONOMY - MEXICO
raok.rept	ROCZNIE ASTRONOMICZNY. OBS. KRAKOWSKIEGO
rarl.conf	1A REUNION ASTRON. REG. LATINOAMERICANA: 1979JAN
rarl.conf	2D REUNION REG. LATINOAMER. ASTRONOMIA JAN, 1981
rasv.rept	RICERCHE ASTRONOMICHE. SPECOLA VATICANA
rasv.rept	RICERCHE SPETTROSC. LAB.ASTROF. SPEC.VAT.
rbls.conf	RELATION BET. LAB. & SPACE PLASMAS - TOKYO, 1980
rbls.conf	RELATION BET. LAB. & SPACE PLASMAS - TOKYO, 1981
rcao.conf	RECOGNITION COMPACT ASTROHYS.OBJECTS:NASA-SP-421
rcch.conf	REL./ CHROMOSPHER.-CORONAL HEAT.&MASS LOSS STARS
regr.conf	RELATIVISTIC GRAVITATION: COSPAR27 ESPOO,FINLAND
regr.symp	SILARG-III: REL.&GRAVIT: 3RD LATIN-AMER.SYMP 1982
rgso.rept	RIJKSUNIVERSITEIT GENT. STERR. OBS. MEDEDELING
ritg.conf	RADIO INTERFEROMETRY TECH. FOR GEODESY JUN1980
rps..conf	RADIO PHYSICS OF THE SUN - IAU SYMP.86 1980
rrl..conf	RADIO RECOMBINATION LINES / OTTAWA,CAN. AUG.1979
rrl..conf	RADIO RECOMBINATION LINES: 25 YEARS IAU COLL.125
rrsb.conf	REC.RES.SOL.BOD.MAG.FIELDS/SOLAR SYST.: COSPAR24
rrsf.conf	REGIONS OF RECENT STAR FORMATION: PENTICTON 1982
rrsf.symp	Regions of recent star formation, eds. Roger, R. S. & Dewdney, P. E., Reidel, Dordrecht, Holland
rrxa.conf	SOME RECENT RESULTS IN X-RAY ASTRONOMY: 1979APRIL
rwsi.conf	RADIO WAVE SCATTERING IN THE INTERSTELLAR MEDIUM
sabc.conf	STELLAR ATMOSPHERES - BEYOND CLASSICAL MODELS
sag..conf	SPACETIME AND GEOMETRY / ALFRED SCHILD LECTURES
sage.conf	STARBURSTS AND GALAXY EVOLUTION: RENC.MORIOND 22
sao..rept	SPECIAL REPORTS. SMITHSONIAN ASTROPH. OBS.
saps.conf	SUN AND PLANETARY SYSTEM: 6TH EUROPEAN REG.MEET.
sasf.conf	SOLAR AND STELLAR FLARES: I.A.U. COLL.104
sath.conf	SUN AND THE HELIOSPHERE: DISCUSSION: APR3&4,1980
sdra.conf	SERENDIPITOUS DISCOVERIES IN RADIO ASTRONOMY: 83
seng.conf	STRUCTURE & EVOLUTION NORMAL GALAXIES - NATO 1981
sens.conf	STRUCTURE AND EVOLUTION OF NEUTRON STARS
seog.conf	SPECTRAL EVOLUTION OF GALAXIES: ERICE 4TH 1986
sep..conf	STUDY OF EARTH AS A PLANET: 1ST ORLOV CONFERENCE
sepa.conf	Structure and Emission Properties of Accretion Disks, Edited by C. Bertout, S. Collin-Souffrin, and J. P. Lasota
seti.conf	THE SEARCH FOR EXTRATERRESTRIAL INTELL: SETI
sfa..meet	SOVIET-FINNISH ASTRON. MEET: - BYURAKAN, JUN1982
sfdg.conf	STAR FORMING DWARF GALAXIES & RELATED OBJECTS
sfmh.conf	sgw..conf	SEARCH OF GRAVITATIONAL WAVES: BOGOTA:82
siha.conf	SCI.IMP. HIGH ANG. RES. INFRARED&OPT. WAVELENGTH
siso.conf	SCIENTIF. IMP. SUBMILLIMETRE OBS: ESA-SP-189: 82
sma..work	ESO-IRAM-Onsala Workshop on (Sub)Millimeter Astronomy
sn87.conf	SUPERNOVA 1987A: 1YEAR LATER:RESULTS&PERSPECTIVES
soap.conf	SPECTROSCOPY OF ASTROPHYSICAL PLASMAS
soia.book	Solar interior and atmosphere (A92-36201 14-92). Tucson, AZ, University of Arizona Press
sofl.symp	HINOTORI SYMPOSIUM ON SOLAR FLARES - TOKYO:1982
sowi.conf	SOLAR WIND 4 - BURGHAUSEN,FDR - AUG18-SEP1, 1981
spie..264	APPL. DIGITAL IMAGE PROC. ASTRONOMY - SPIE
spie..290	SOLID STATE IMAGERS FOR ASTRONOMY: SPIE#290 1981
spie..331	INSTRUMENTATION IN ASTRONOMY IV: TUCSON: SPIE331
spie..332	ADVANCED TECHNOLOGY OPTICAL TELESCOPES: SPIE332
spie..556	INTERNATIONAL CONFERENCE ON SPECKLE / SPIE 556
spie..597	X-RAY INSTRUMENTATION IN ASTRONOMY SPIE:597
spie.1242	CCD AND SOLID STATE OPTICAL SENSORS: SPIE:1242
spie.1542	ACTIVE AND ADAPTIVE OPTICAL SYSTEMS SPIE 1542
spie.1979	INTERFEROMETRY - SPIE#1979- SAN DIEGO CALIF 1979
sps..conf	SPECTRES MOLECULES SIMPLES - COLL.LIEGE, JUN1980
spss.conf	SOLAR PHEN. IN STARS & STELLAR SYST. - NATO 1981
sptc.conf	SPACE MISSIONS TO COMETS: NASA-CP-2089: OCT 1979
srps.conf	SPACE RES.PROSPECTS/STELL.ACTIVITY & VARIABILITY
srs..conf	SOLAR RADIO STORMS: 4TH CESRA: TRIESTE: 1982AUG
sscr.conf	SUPERNOVAE: SURVEY CURR. RES.: NATO:CAMBRIDGE 81
sse..conf	SOLAR SYST.&EXPLOR.: ALPBACH: ESA#164 81JUL/AUG
ssg..work	SURVEYS OF THE SOUTHERN GALAXY: WORKSHOP: LEIDEN
sslu.conf	STRAT. SEARCH LIFE/UNIVERSE - MONTREAL - AUG1980
sssg.conf	SUPERSPACE&SUPERGRAVITY: NUFFIELD/CAMBRIDGE 1980
sssg.conf	SUPERSYMMETRY AND SUPERGRAVITY '82 / TRIESTE
stat.conf	STELLAR ATMOSPHERES: NSF CONF: INDIANA U: 1954
stcl.symp	STAR CLUSTER SYMP. BUDAPEST: PUBL.EOTVOS UNIV.
stfo.conf	STAR FORMATION - 10TH SAAS FEE - MARCH24-29 1980
stfo.work	STAR FORMATION: WORKSHOP: EDINBURGH 1983OCT4-6
stga.rept	STUDI GALILEIANI. VATICAN OBS. PUBL.
sto..conf	SPACE TELESCOPE OBS.: IAU.GEN.ASSEMB18: PATRAS:
sto..conf	SPACE TELESCOPE OBSERVATORY: IAU COMM.44 1982AUG
stob.rept	REPORT. STOCKHOLMS OBSERVATORIUM. SALTSJOBADEN
stp..conf	SOLAR-TERRESTRIAL PHYSICS: BOSTON COLLEGE: 82AUG
stro.coll	Stellar Rotation, ed. A. Sletteback (Dordrecht: Reidel)
sttu.conf	STELLAR TURBULENCE - IAU COLL.51 - ONTARIO 1980
sugr.conf	SUPERGRAVITY '81: 1ST SCHOOL, TRIESTE,ITALY
susp.conf	SUPERNOVAE SPECTRA - LA JOLLA - AIP CONF#63 1980
swng.conf	Science With The Next Generation of Space Telescope, Eric P. Smith and Anuradha Koratkar
swrc.conf	SOURCES OF GRAVITATIONAL RADIATION - JUL-AUG1979
swrc.conf	SOUTHWEST REG. CONF. ASTRON. & ASTROPHYSICS
swrc.conf	SOUTHWEST REG. CONF. ASTRON.&ASTROPH.,
swrc.conf	SOUTHWEST REG. CONF. ASTRONOMY & ASTROPHYS.:
syim.conf	SYNTHESIS IMAGING / NRAO SCHOOL SOCORRO 1986AUG
syma.work	NRAO/VLA WORKSHOP: SYNTHESIS MAPPING: 1982JUNE21
syst.work	NORTH AMER. WORKSHOP SYMBIOTIC STARS - JUNE,1981
tdp..conf	ESO: TWO-DIMENS. PHOTOM.: NOORDWIJKERHOUT, 1979
tip..conf	5TH GEN.CONF.EUR.PHYS.SOC:TRENDS IN PHYSICS 1982
tisn.work	TYPE-I SUPERNOVAE: PROC. TEXAS WORKSHOP - 1980MAR
tphr.conf	THEO. PROB. HIGH RESOLUTION SOLAR PHYS.:
ttxa.symp	in Proc. 23rd ESLAB Conference on X-Ray Astronomy, Vol. 1; X-Ray Binaries, ed. J. Hunt & B. Battrick 
turk.rept	TURKU UNIV. OBS. REPORT SER. INFORMO
turk.rept	TURKU UNIV. OBSERVATORY REPORT SERIES. INFORMO
uft..conf	UNIFIED FIELD THEORIES OF >4 DIMENSIONS
uhur.symp	UHURU MEM. SYMP X-RAY ASTRONOMY - GREENBELT 1981
umh..conf	UNIVERSITE MONS-HAINAUT. ASTROPH.&SPECTR. COMM.
umsc.conf	UPPER MAIN SEQ. CHEM. PEC. STARS - 23RD LIEGE 81
umss.conf	ASTROPHYS.PROC./UPPER MAIN SEQ.STARS: SAAS-FEE13
urbp.symp	5TH ESA SYMP. EUR. ROCKET BALLOON PROG. - APR1980
usoa.conf	USE OF SUPERCOMPUTERS IN OBSERVATIONAL ASTRONOMY
utu..conf	UNDERSTANDING THE UNIVERSE / UNISPACE 82 VIENNA
uvsc.conf	UV STELLAR CLASSIFICATION: VILSPA: ESA#182 81OCT
veu..conf	THE VERY EARLY UNIVERSE / NUFFIELD / 1983JUN/JUL
vlba.conf	MULTIDISCIPLINARY USE / VERY LONG BASELINE ARRAY
vlbi.conf	VLBI TECHNIQUES - TOULOUSE,FRANCE: CONF. 1982AUG
vlt..work	ESO'S VERY LARGE TELESCOP: CARGESE: 1983MAY16-19
vlt..work	ESO'S VERY LARGE TELESCOPE: WORKSHOP 2: VENICE
vlti.conf	VERY LARGE TELESCOPES/INSTRUM.&PROG:IAU COLL.79
vob..conf	VARIABILITY OF BLAZARS
vrsp.conf	VIB-ROT.SPECT.PLANET.ATMOS:NASA CP 2223: 1982MAR
vsc..conf	VARIATIONS SOLAR CONSTANT: NASA-CP-21981 1980NOV
vsg..conf	VARIAB. STARS&GALAX.: EUR.REG.MTG.#5:LIEGE1980
vsg..conf	VARIAB. STARS&GALAX.: EUR.REG.MTG.#5:LIEGE1980 P. C
vsr..conf	VARIABLE STAR RESEARCH: INTERNAT'L. PERSPECTIVE
wdir.conf	WARPED DISKS AND INCLINED RINGS AROUND GALAXIES
xaes.conf	X-RAY ASTRON. W/ EINSTEIN SAT. CAMBRIDGE 1981JAN
xaes.conf	X-RAY ASTRONOMY WITH THE EINSTEIN SATELLITE 1981
xra..symp	18TH ESLAB SYMP.: X-RAY ASTRONOMY / SCHEVENINGEN
xray.symp	X-RAY SYMPOSIUM / COLGATE UNIV.:HAMILTON,NY 1982
xue..conf	X-RAY & UV EMISSION FROM ACTIVE GALACTIC NUCLEI
LPSC.....	Proc. Lun. Plan. Sci. Conf.
AIPC.....	AIP Conf. Proc.
modg.proc	Proc. 12th Saas-Fe Advanced Course Morphology and Dynamics of Galaxies (Geneva Obs. Pub.)
modg.proc	Twelfth Advanced Course of the Swiss Society of Astronomy and Astrophysics (Saas-Fee): Morphology and Dynamics of Galaxies
lssu.proc	Large-Scale Structure in the Universe, 17th Advanced Course of Swiss Society of Astrophysics (Saas-Fee), ed. L. Martinet and M. Mayor (Geneva: Geneva Observatory)
mwag.conf	The Milky Way as a Galaxy, 19th Saas-Fee Course, ed. R. Buser & I. King
nce..conf	Nucleosynthesis and Stellar Evolution
agn..conf	Saas-Fee Advanced Course 20 Lecture Notes, Active Galactic Nuclei, ed. R. D. Blandford, H. Netzer, & L. Woltjer (Berlin: Springer)
gim..conf	The Galactic Interstellar Medium, ed. D. Pfenniger & P. Bartholdi (Saas-Fee Advanced Course 21; Berlin: Springer)
inbi.conf	Interacting Binaries, Saas-Fee Advanced Course 22, ed. H. Nussbaumer & A. Orr 
plas.conf	Plasma Astrophysics, Saas-Fee Advanced Course 24 Lecture Notes 
cmaf.conf	Computational Methods for Astrophysical Fluid Flow, lecture notes 1997/Saas-Fee Advanced Course 27, ed. O. Steiner & A. Gautschy (Berlin: Springer)
ASSL...13	Mass loss from stars, Ed. M. Hack, Astrophysics and Space Science Library Vol. 13
ASSL...88	Physical Processes in Red giants, Astrophysics and Space Library Vol. 88
ASSL..132	The Late Stages of Stellar Evolution, Astrophysics and Space Library Vol. 132
